scaffold_1	reverse	GTCTGCCACTCTTAGGGTTAGGGTTAGGGTTAGGGTTAGGGTTAGGGTTAGGGTTAGGGTTAGGGTTAGGGTTAGGGTTAGGGTTAGGGTTAGGGTTAGG
scaffold_2	reverse	GCCTACGCCGCTCGAGCCCCTTCACTCAACTCCGGCGTCTGGACTTGTAGATAGGTTAGGGTTAGGGGTTAGGTTAGGGTTAGGGTTAGGGTTAGGGTTA
scaffold_3	forward	TAACCCTAACCCTAACCCTAACCCTAACCCTAACCCTAACCCTAACCCTAACCCTAACCTAACCCTAACCTAACCCAGAGGAGTGTTCCATAAAGGTGGA
scaffold_3	reverse	GGTAGGGTTAGCGGTTAGGGTTAGGGTCAGGGTCAGGGTTAGGGTTAAGGGTTAGGGTTAGGGTTAGGGTTAGGGTTAGGGTTAGGGTTAGGGTTAGGGT
scaffold_4	forward	CTAACCCTAACCCTAACCCTAACCCTAACCCTAACCCTAACCCTAACCCTAACCCTAACCCTAGCCCTAACCCTAACCCTAACCCTAACCCTAACCCTAA
scaffold_4	reverse	GGAAAGGGTTAGGGTTAGGGTTAGGGTTAGGGTTAGGGTTAGGGTTAGGGTTAGGGTTAGGTTAGGGTTAGGGTTAGGGTTAGGGTTAGGGTTAGGGTTA
scaffold_6	forward	CTAACCCTAACCCTAACCCTAACCCTAACCCTAACCCTAACCCTAACCCTAACCCTAACCCTAACCCTAACCCTAACCCTAACCCTAACCTTGACCCTAA
scaffold_6	reverse	GTTAGGGTTAAGGTCAGGGTTAGAGTTAAGGTTAGGGCTAGGGTTAGGGTTAGGGTTAGGGTTAGGGTTAGGGTTAGGGTTAGGGTTAGGGTTAGGGTTA
scaffold_7	reverse	ACGGACACGAGGGTTAGGGTTAGGGTTAGGGTTAGGGTTAGGGTTAGGGCTAGGGTTAGGGTTAGGGTTAGGGTTAGGGTTAGGGTTAGGGTTAGGGTTA
scaffold_8	reverse	TAGGGTTAGGGTTAGGGTTAGGGTTAAGGTTAGGGTTAGGGTTAGGGTTAGGGTTAGGGTTAGGGTTAGGGTTAGGGTTAGGGTTAGGGTTAGGGTTAGG
scaffold_9	forward	AACCCTAACCCTAACCCTAACCCTAACCCTAACGCTAACCCTAACCCTAACCCTAACCCTAACCCTAACCCTAACCCTAACCCTAACCCTAACCCTAACC
scaffold_9	reverse	TCGTGGACAAGGTTAGGGTTAGGGTTAGGGTTAGGGTTAGGGTTAGGGTTAGGGTTAGGGTTAGGGTTAGGGTTAGGGTTAGGGTTAGGGTTAGGGTTAG
scaffold_10	forward	AACCCTAACCCTAACCCTAACCCTAACCCCTAACCTAACCCTAACCCTAACACTAACCTAACCCTAACCTCAAATCGACGACGGCAAGAGGGCATGCCAC
scaffold_10	reverse	GAGGGTTAGAGGTAGGGTTAGGGTTAGGGTTATGGTTAGGGTTATGGTTAGGGTTATGGTTAGGGTTAGGGTTAGGGTTAGGGTTAGGGTTAGGGTTAGG
scaffold_11	forward	CCTAACCCTAACCCTAACCCTAACCCTAACCCTAACCCTAACCCTAACCCTAACCCTAACCCTAACCCTAACCCTGACCGTAAGCATCTATGCGCCGCGC
scaffold_12	forward	TAACCCTAACCCTAACCCTAACCCTAACCCTAACCCTAACCCTAACCCTAACCCTAAACGCGGCCTGAGCGCATCGGAGCACGCGCCTCTTCGGATTGTC
scaffold_12	reverse	TCCGAGGAAGCTTGCCGCGAAGGGTTAGGGTTAGGGTTAGGGTTAGGGTTAGGGTTAGGGTTAGGGTTAGGGTTAGGGTTAGGGTTAGGGTTAGGGTTAG
scaffold_13	forward	TAACCCTAACCCTAACCCTAACCCTAACCCTAACCCTAACCCTAACCCTAACCCTAACCTAACCCTAACCCTAACCCTAACCTAACCTAACCGTTGTGCG
scaffold_14	forward	ACCCTAACCCTAACCCTAACCCTAACCCTAACCCTAACCCTAACCGTAACCCTAACCCTAACCCTAACCGTAACCCTAACCCTAACCCTACCGCTCATCC
scaffold_15	reverse	GTTAGGGTTAGGGGTAGGGTCAGGGTTAGGGTTAGGGTTAGGGTTAGGGTTAGGGTTAGGGTTAGGGTTAGGGTTAGGGTTAGGGTTAGGGTTAGGGTTA
scaffold_17	forward	CCCTAACCCTAACCCTAACCCTAACCCTAACCCCAACCCTAACCCTAACCCTAACCCTAACCCTAACCCTAACCCTAACCCTAACCCTAACCCTAGCCCT
scaffold_18	forward	TAACCCTAACCCTAACCCTAACCCTAACCCTAACCCTAACCCTAACCCTAACCCTAGCCTTAACCCTAACCCTAACCCTTAACCCTAACCCTAACCCTAA
scaffold_19	reverse	TCTATGCAGTTTTCGAAAAGTGAAAACTGGTTAGGGTTAGGGTTAGGGTTAGGGTTAGAGTTAGGGTTAGGGTTAGGGTTAGGGTTAGGGTTAGGGTTAG
scaffold_20	reverse	GTTAGGGTTAGGGTTAGGGTTAGGGTTAGGGTTAGGGTTAGGGTTAGGGTTAGGGTTAGGGTTAGGGTTAGGGTTAGGGTTAGGGTTAGGGTTAGGGTTA
scaffold_21	forward	ACCCTAACCCTAACCCTAACTCTAACCCTAACCCTAACCCTAACCCTAACCCCTAACCCTAACCCTAACCCTAACCCTAACCCTGACCCTGACCTAACCC
scaffold_22	forward	CCCTAACCCTAACCCTAACCCTAACCCTAACCCTAACCCTAACCCTAACCCTAAGCTCATCCTAACCCTAACCTAACCCTAACCTAACCCTAACCCTAAG
scaffold_23	reverse	TTAGGGTTAGGGTTAGGGTTAGGGTTAGGGTTAGGGTTAGGGTTAGGGTTAGGGTTAGGGTTAGGGTTAGGGTTAGGGTTAGGGTTAGGGTTAGGGTTAG
scaffold_24	forward	TAACCCTAACCCTAACCCTAACCCTAACCCTAACCCTAACCCTAACCCTAACCCTAACCCTAACCCTAACCCTAACCCTAACCCTAACCCTAACCCTAAG
scaffold_27	forward	CCTAACCCTAACCCTAACCCTAACCCTAACCCTAACCCTAACCCTAACCCTAACCCTAACCCTAACCCTAACCCTAACCGAGGGCATCGAGGCGGATCCG
scaffold_29	forward	AACCCTAACCCTAACCCTAACCCTAACCCTAACCCTAACCCTAACCCTAACCCTAACCCTAACCCTAACCCTAACCCTAACCCTAGCCTTTGACCCTGAC
scaffold_30	reverse	GTCAGGGTCAGGGTCAGGGTTAGGGTTAGGGTTAGGGTTAGGATTAGGGTTAGGGTTAGGGTAGGATTAGGGTTAGGGTTAGGGTTAGGGTTAGGGTTAG
scaffold_33	forward	CCCTAACCCTAACCCTAACCCTAACCCTAACCCTAACCCTAACCTAACCCTAACCCTAACCCTAACCTAACCCTAACCCTAACCCTAACCCTAACCTTAA
scaffold_34	forward	TAACCCTAACCCTAACCTAAGGCTCAAAGCTCGTCCTCAGCAGAAGCGAGAGAAGCAGACAAAGCAGGGCCGAGCTGCGCCGAGTTTGCTTCCAGATTTC

Telomeres found: 33 (18 forward, 15 reverse)
