scaffold_1	forward	ACCCTAACCCTAACCCTAACCCTAACCCTAACCCTAACCCTAACCCTAACCCTAACACCTCCTCCTCCTCCTCCTCTTGACACAAGTCTAGCTCTTGCTG
scaffold_2	forward	CCCTAACCCTAACCCTAACCCTAACCCTAACCCTAACCCTAACCTAACCCTAACCCTTAGTCTTAGCCCTAACCCTAACCTCATTGTCGACCGACGCGAT
scaffold_4	forward	CCCTAACCCTAACCCTAACCCTAACCCTAACCCTAACCCTAACCTTGACCCTAACCCTAATCCTAAACCTAACCCTGGCCGGCGCGATCAGTGACAACCC
scaffold_5	reverse	CCAGTGACAGTGAGCCCAGGAGGGCGTTCCTTGAGGTAGATTTAGGGTTAGGGTTAGGATTAGGGTTAGGGTTAGGGTTAGGGTTAGGGTTAGGGTTAGG
scaffold_6	forward	CCTAACCCTAACCCTAATCCTAACCCTAACTCTAACCCTAACCCTAACCCTAACCCTAGCCCTAAGATCTACTCGCTGCTCGGCGCCGTCAAAAACCTCG
scaffold_6	reverse	CTTGCGGCCGCCTGTCTGTCAAGCTACCCCACGCTTACGGTTACGGTTAGGGTTAGGGTTAGGGTTAGGGTTAGGGTTAGGGTTAGGGTTAGGGTTAGGG
scaffold_7	forward	CCCTAACCCTAACCCTAACCCTAACCCTAACCCTAACCCTAACCCTAAACACTAACCCTAACCCGAAGCGGTGCGAGCTCCCGATGGAGTGAATCTGGCG
scaffold_7	reverse	CCTGAATCACCTGCGTGGCGAGGCGTCTTAGGGTTAGGGTTAGGGTTAGGGTTAGGGTTAGGGTTAGGGTTATGGTTAGGGTTAGGGTTAGGGTTAGGGT
scaffold_8	forward	CCTAACCCTAACCCTAACCCTAACCCTAACCCTAACCCTGACCCTAACCCTAACCTTAACCTTAACCCTAACCCTAATCCTGACCCTAACCCTAACCCTA
scaffold_8	reverse	GACCGCACGGGAGAACCAGCTCCTCGTCGTCGTCCCCCCTCCCAGCTCTTAGGGTTAGGGTTAGGGTTAGGGTTAGGGTTAGGGTTAGGGTTAGGGTTAG
scaffold_9	forward	CCTAACCCTAACCCTAACCCTAACCCTAACTCGAGCGCCAACATCGTCCATCTCGAGCGTCGTGTGCCGCCGCTCACTGTCGCAAGCAGCAGGCTCAAAG
scaffold_11	forward	TAACCCTAACCCTAACCCTAACCCTAACCCTAACCCTAACCTAACCCTAACCCTAAGGCGGACTCTCGCCCAGACGCAGACCAGCTGCATTGCAAAGGCT
scaffold_11	reverse	CATCAAGCCACCGACGTCGCTCGACCCCCACGGCGCGTCCCGAGCTCTTAGGGTTAGGGTTAGGGTTAGGGTTAGGGTTAGGGTTAGGGTTAGGGTTAGG
scaffold_13	forward	CTAACCCTAACCCTAACCCTAACCCTAACCCTAACCCTAACCCTAACCCTAACCCTAACCCTAACTAACCTCAGTGCTGGCTGCAGGGAAGCCGACGAGG
scaffold_14	forward	CCCTAACCCTAACCCTAACCCTAACCCTAACCCTAACCCTAACCCTAACCCTAACCCTAAGATGGGCCAGTCCAGATCCAAACGGGCGGTTCGACTTGGT
scaffold_15	forward	GTTTTTTTTTTTTTTTTTAACCCTAACCCTAACCCTAACCCTAACCCTAACCCTAACCCTGGGTCCCGTTCGCGCTCGTCAAGGAGTCGATCCGCGAGGT
scaffold_17	forward	CCTAACCCTAACCCTAACCCTAACCCTAACCCTAACCCTAACCCTAACGCAGAACGAGCCGGCTCGATCGCGCGAGCGCCAAAGAGCGACATTCGCGCGC
scaffold_20	reverse	TCGTCAGCAGCACCCCGCCCTCGCCCAGCCGCCGTGCATCTTAGGGTTAGGGTTAGGGTTAGGGTTAGGGTTAGGGTTAGGGTTAGGGTTAGGGTTAGGG
scaffold_23	reverse	GGGTTAGGGTTAGGGTTAGGGTTAGGGTTAGGGTTAGGGTAGGGTGCTCGGTTCCCGATTGCTTAGCAGTGCATATGTTTAACCTTAGCAATACGTAACT
scaffold_25	reverse	GTGCAAGGCGCAGGACCGCTCGACAGTCACTGGGCGCCAGCGCTTAGGGTTAGGGTTAGGGTTAGGGTTAGGGTTAGGGTTAGGTTAGGTTAGGGTTAGG
scaffold_31	reverse	TTTTGAAACTTGGGTTAGGGTTACGCGATTCGCTCTTTTCCTCGCTTTCCTCGGTTCCCTCGCTTGCTTCAGGGTTCTCCTTCCTCTTTCTTGGTGCCAG
scaffold_32	forward	CCTAACCCTAACCCTAACCCTAACCCTAACCCTAACCCTAACCCTAACCCTAACCCTAAGATGGGCGATGCATGCCGGCTGAACGACGGCTGGATGCTGC

Telomeres found: 22 (13 forward, 9 reverse)
