scaffold_1	reverse	GGGGTAGGGTTAGGGTTAGGGTTAGGGTTAAGGATAAGGTTAGAGTTAGGGTTAGGGTTAGGGTTAGGGTTAGGGTTAGGGTTAGGGTTAGGGTTAGGGT
scaffold_2	reverse	ATCGCCTTAGGGTTAGGGTTAGGGTTAGGGTTAGGGTTAGGGTTAGGGTTAGGGTTAGGGTTAGGGTTAGGGTTAGGGTTAGGGTTAGGGTTAGGGTTAG
scaffold_3	reverse	TAGGGTTAGGGTTAAGGCGAGGGTTAGGGTTAGGGCTAGGGTTAGGGTTAGGGTTAGGGTTAGGGTTAGGGTTAGGGTTAGGGTTAGGGTTAGGGTTAGG
scaffold_4	forward	CCTAACCCTAACCCTAACCCTAACCCTAACCCTAACCCTAACCCTAACCCTAGCCCTAACCCTAACTCTAACCCTAACCCTAACCTGTGCGAAAAGTTCC
scaffold_4	reverse	TTAGGATTAGGGTTATGGTTAGGGTTAAGGTTAGGGTTAGGGTTAGGGTTAGGGTTAGGGTTAGGGTTAGGGTTAGGGTTAGGGTTAGGGTTAGGGTTAG
scaffold_5	reverse	TAGGTTAGGGTTAGGATCAAGGTCAGGGTTAGGGTTAGGGTTAAGGTTAGGGTTAGGGTTAGGGTTAGGGTTAGGGTTAGGGTTAGGGTTAGGGTTAGGG
scaffold_6	reverse	CCCCTTCAGTTGTGCTCAGTTAAGGTTAGGTTAGGTTAGGTTAGGGTTAGGGTTAGGGTTAGGGTTAGGGTTAGGGTTAGGGTTAGGGTTAGGGTTAGGG
scaffold_8	forward	CCTAACCCTAACCCTAACCCTAACCCTAACCCTAACCCTAACCCTAACCTAACCCTAACCCTAACCCTAACCCTAACTTTAACCCTAACCCTAACTTTAA
scaffold_8	reverse	GGGTTAAGGGTTAAGGTTAGGATTAGAGTTAGGGTTAGGGTTAGAGTTAGGGTTAGGGTTAGGGTTAGGGTTAGGGTTAGGGTTAGGGTTAGGGTTAGGG
scaffold_9	forward	CTAACCCTAACCCTAACCCTAACCCTAACCCTAACCCTAACCCTAACCCTAACCCTAACCCTAACCCTAACCCTAACCCTAACCCTAACCCTAACCCTGA
scaffold_10	forward	ACCCTAACCCTAACCCTAACCCTAACCCTAATCCTAACCCTAACCTTAACTCTAACCCTAACCCTAACCCTAACCTAACCCTAACCCTAGGTCATTTTTC
scaffold_11	forward	CCCTAACCCTAACCCTAACCCTAACCCTAACTCTAACCCTAACCCTAACCCTAACCCTTAACCCTAACCCTAACCTAACCCTAACCCTAACCGGACTGGG
scaffold_11	reverse	GGTTAGGGTCAGGGTCAGGGGTAGGGTTAGGGTTAGGGTTAGGGCTAGGGTTAGGGCTAGGGTTAGGGTTAGGGTTAGGGTTAGGGTTAGGGTTAGGGTT
scaffold_12	forward	AACCCTAACCCTAACCCTAACCCTAACCCTAACCCTAACCCTAACCCTAACCCTAACCCTAACCCATAACCCTAACCCTAACCCTAACCCTAACCCTACT
scaffold_13	reverse	GAGAATACTGACTTTGGGGGCCTTCTCCCAGTAGCAGAAGAGAACTGAAAATACGTCGTTCCTTAGGGTTAGGGTTAGGGTTAGGGTTAGGATTAGAGTT
scaffold_15	reverse	AGGTTAGGGTTAGGGTAAGGATTAGGGTTAGGGTTAGGGTTAGGGTTAGGGTTAGGGTTAGGGTTAGGGTTAGGGTTAGGGTTAGGGTTAGGGTTAGGGT
scaffold_16	forward	CCCTAACCCTAACCCTAACCCTAACCCTAACCCTAACCCTAACCCTAACCCTAACCCTAACCCTAACCTAACCTAACCCTAACCCTAACCTTCGAATGGT
scaffold_17	forward	ACCCTAACCCTAACCCTAACCCTAACCCTAACCCTAACCCTAACCCTAACCCTAACCCTAACCCTAACCCTAATCCTAACCCTAATCCTAACCTACTCTA
scaffold_20	reverse	GGGTTAGGGTTAGGGTTAGGGTTAGGGTTAGGGTTAGGGTTAAGGTTAGGGTTAGGGTTAGGGTTAGGGTTAGGGTTAGGGTTAGGGTTAGGGTTAGGGT

Telomeres found: 19 (8 forward, 11 reverse)
