scaffold_1	reverse	GAGCGCCAGCGAGTCTCTTTGCTTGATCTATGCGGTAAGGGTTAGGGTTAGGGTTAGGGTTAGGGTCAGGGTTAGGGTTAGGGTTAGGGTTAGGGTTAGG
scaffold_2	forward	ACCCTAACCCTAACCCTAACCCTAACCCTAACCCTAACCCTAACCCTAACCCTAACCCTAACCCTGACCCTCGTCAACTCGCAGACGGTCGTCTCAAACG
scaffold_3	forward	TAACCCTAACCCTAACCCTAACCCTAACCCTAACCCTAACCCTAACCCTAACCCTAACCCTAAGTTGCATGTGCAAGCGAGATAGGTCTCCTCCTCGTCT
scaffold_4	reverse	GCCACGAAACGAGGTAGGCTTAGGAGGGTACCGGCACCGAGGTTAGGGTCAGGGTTAGGGTTAGGGTTAGGGTTAGGGTTAGGGTTAGGGTTAGGGTTAG
scaffold_5	forward	CCCTAACCCTAACCCTAACCCTAACCCTAACCCTAACCCTAACTCTAATCCGCAGCAAGTGCAGACCCCGCAGCAGCAGCAGCTTGCCGGCTCGAACGGC
scaffold_6	forward	CGTCCTTGCTGCGCCTTTCCTGTCGCAACGCCCCCCAAGCCCCCCAAGGGGGGCTTTGTTTCACATACACCCTAACCATCTAGGGCTAACCCTAACCTCT
scaffold_6	reverse	AGGGAAGGGAAATCGGGACAAGCTTTCGCGCCAGAAATACTGAGGGTTAGGGTTAGGGTTAGGGTTAGGGTTAGGGTTAGGGTTAGGGTTAGGGTTAGGG
scaffold_7	forward	TAACCCTAACCCTAACCCTAACCCTAACCCTAACCCTAACCCTAACCCTAACCCTAACCCTTTCGCACCAAGAACAAGCATGAAAAGGGGCAGAACGGAC
scaffold_8	forward	CTAACCCTAACCCTAACCCTAACCCTAACCCTAACCCTAACCCTAACCCTAACCTAAGTTGCGCCAGGTGACAGTGCATTTGCACCGGCGTCTACGCCTC
scaffold_8	reverse	CCTCCCACGGTTGGCATGTGACGCTGCTCCTTTGCTTTGACCTTAGGGTTAGGGTTAGGGTTAGGGTTAGGGTTAGGGTTAGGGTTAGGGTTAGGGTTAG
scaffold_9	forward	TAACCCTAACCCTAACCCTAACCCTAACCCTAACCCTAACCCTAACCCTAACCCTAACCCTAACCCTAACCCTAACCCTAACCCTAACCCTAACCCTAAC
scaffold_9	reverse	ACTTGCCGCGGCGAGTCTCCGCGCCTCGTCCTCGTTAGCGTTAGGGTTAGGGTTAGGGTTAGGGTTAGGGTTAGGGTTAGGGTTAGGGTTAGGGTTAGGG
scaffold_10	forward	CCTAACCCTAACCCTAACCCTAACCCTAACCCTAACCCTAACCCTAACCCTAACCCTAACCCTGAGGCAGGTTGCAACATCAAGACAGAACCGCAGCCAT
scaffold_10	reverse	AGTGGAAAGCCAGGACTTAGGGTTAGGGTCAGAGTTAGGGTTAGGGTTAGGGTTAGGGTTAGGGTTAGGGTTAGGGTTAGGGTTAGGGTTAGGGTTAGGG
scaffold_11	reverse	ATCGGCATCCGGTCGCAGTAAACGTCTCAGGGCTAGGTTAGGGTTAGGGTTAGGGTTAGGGTTAAGGTTAGGGTTAGGGTTAGGGTTAGGGTTAGGGTTA
scaffold_12	forward	AACCCTAACCCTAACCCTAACCCTAACCCTAACCCTAACCCTAACCCTAACCTACCCCTAACCACCAGCTCGACGACGCCGCCGGCCTCCCCGCCCCCTC
scaffold_12	reverse	AGGGACCGGTGAAACACGCAAAAGTCACGATTTTGTGCGGTAGGGTTAGGGTTAGGTTAGGGTTAGGGTTAGGGTTAGGGTTAGGGTTAGGGTTAGGGTT
scaffold_13	forward	AACCCTAACCCTAACCCTAACCCTAACCCTAACCCTAACCCTAACCTTGACCCTAACCCTAACCCTAGTGACAACCGTTGAGACAGCGATCCGCAAGAAG
scaffold_15	reverse	CCTTAACAGGGCTCGACGGCGCGGTCGAGGACGTCAAGCGCGTCGTGCCAGACTGGGGGTTAGGGTTAGGGTTAGGGTTAGGGTTAGGGTTAGGGTTAGG
scaffold_16	forward	TAACCCTAACCCTAACCCTAACCCTAACCCTAACCCTAACCCTAACCCTAACCCTAAGTCTGATGGTACCCTAACTGGCCCCCTAACTGGCTGGCCCCTA
scaffold_19	reverse	TTAGGGTTAGGGATATCCAGAACCTCTCGAGTTAGGGTTAGAGTTAGAGTTAGGGTTAGGGTTAGGGTTAGGGTTAGGGTTAGGGTTAGGGTTAGGGTTA
scaffold_23	reverse	CGGTGGTAGAAGAGCCGGTGCTGGCTCATTGGGCGAGGTGGTGTTAGGGTTAGGGTTAGGGTTAGGGTTAGGGTTAGGGTTAGGGTTAGGGTTAGGGTTA
scaffold_25	reverse	TGCTCTCCGCTCTTTCTCCTTGCTTGCAGCTCCCGACTGCGCAACTCACGAGTTAGGGTTAGGGTTAGGGTTAGGGTTAGGGTTAGGGTTAGGGTTAGGG
scaffold_26	forward	TAACCCTAACCCTAACCCTAACCCTAACCCTAACCCTAACCCTAACCCTAACCCTAAGGCGTGTACGAGTTGATATCGGTGCCGAGGTATCCAATGTAGT
scaffold_27	reverse	TAGTCTTCTTAGGGTTAAGGGTTAGGGTTAGGGTCAGGGTTAAGGATTAGGATTAGGGTTAGGGTTAGGGTTAGGGTTAGGGTTAGGGTTAGGGTTAGGG
scaffold_28	reverse	GCAAAAGTCACGATTTTGTGCGGTACTTGCATGTGCTTAGGGTTAGGTTAGGGTTAGGGTTAGGGTTAGGGTAGGGTTAGGGTTAGGGTTAGGGTTAGGG
scaffold_29	forward	TAACCCTAACCCTAACCCTAACCCTAACCCTAACCCTAACCCTAACCCTAACCCTGAACCTAACCCTGACCCTAAGTTGCGTCTTCTCGCGCGAAAGCAA
scaffold_31	forward	AACCCTAACCCTAACCCTAACCCTAACCCTAACCCTAACCCTAACCCTAACCCTAACCCTAACCCTAGGAAAGAGAGCACCAGAGGATAGAGGAAGGGGA
scaffold_33	forward	CCTAACCCTAACCCTAACCCTAACCCTAACCCTAACCCTAACCTAACCTAACCCTAACCCTAACCCTAACCCTGGAGTTCCCAAAAGCTGGCTACACCCA
scaffold_35	forward	CCCTAACCCTAACCCTAACCCTAACCCTAACCCTAACCCTAACCCTAACCCTAACCCTAACCCTAACCTGATATTGTGCATTTTTCAGAGTCTGATGGTG
scaffold_36	forward	ACCCTAACCCTAACCCTAACCCTAACCCTAACCCTAACCCTAACCCTAACCCTAACCCTAAGTTGCGTCTCAGGGGCAGTGCTAGCCCCGGAGGAAGGAG
scaffold_37	forward	CCTAACCCTAACCCTAACCCTAACCCTAACCCTAACCCTAACCCTAACCCTACCCCTAACCCTATAACCCTAACCTAAATTTGCGTGGCAGTCAGATTGG
scaffold_42	reverse	CAAGCAGATCGGGAAGGTCAACTTGCAGAGTTGCTGGTTCAATCATGCTTGTGGGTTAGGGTTAGGGTTAGGGTTAGGGTTAGGGTTAGGGTTAGGGTTA

Telomeres found: 33 (18 forward, 15 reverse)
