contig_17	forward	CCTAACCCTAACCCTAACCCTAACCCTAACCCTAACCCTAACCCTAACCCTAACCCTAAGATGGGCGATGCATGCCGGCTGAACGACGGCTGGATGCTGC
contig_2	forward	CTAACCCTAACCCTAACCCTAACCCTAACCCTAACCCTAACCCTAACCCTAACCCTAACCCTAACTAACCTCAGTGCTGGCTGCAGGGAAGCCGACGAGG
contig_25	forward	ACCCTAACCCTAACCCTAACCCTAACCCTAACCCTAACCCTAACCCTAACCCTAACACCTCCTCCTCCTCCTCCTCTTGACACAAGTCTAGCTCTTGCTG
contig_26	forward	CCTAACCCTAACCCTAACCCTAACCCTAACTCGAGCGCCAACATCGTCCATCTCGAGCGTCGTGTGCCGCCGCTCACTGTCGCAAGCAGCAGGCTCAAAG
contig_27	forward	CCCTAACCCTAACCCTAACCCTAACCCTAACCCTAACCCTAACCTTGACCCTAACCCTAATCCTAAACCTAACCCTGGCCGGCGCGATCAGTGACAACCC
contig_3	reverse	TCGTCAGCAGCACCCCGCCCTCGCCCAGCCGCCGTGCATCTTAGGGTTAGGGTTAGGGTTAGGGTTAGGGTTAGGGTTAGGGTTAGGGTTAGGGTTAGGG
contig_31	reverse	TTTTGAAACTTGGGTTAGGGTTACGCGATTCGCTCTTTTCCTCGCTTTCCTCGGTTCCCTCGCTTGCTTCAGGGTTCTCCTTCCTCTTTCTTGGTGCCAG
contig_33	forward	CCTAACCCTAACCCTAATCCTAACCCTAACTCTAACCCTAACCCTAACCCTAACCCTAGCCCTAAGATCTACTCGCTGCTCGGCGCCGTCAAAAACCTCG
contig_33	reverse	CTTGCGGCCGCCTGTCTGTCAAGCTACCCCACGCTTACGGTTACGGTTAGGGTTAGGGTTAGGGTTAGGGTTAGGGTTAGGGTTAGGGTTAGGGTTAGGG
contig_40	forward	CCCTAACCCTAACCCTAACCCTAACCCTAACCCTAACCCTAACCTAACCCTAACCCTTAGTCTTAGCCCTAACCCTAACCTCATTGTCGACCGACGCGAT
contig_43	reverse	CCAGTGACAGTGAGCCCAGGAGGGCGTTCCTTGAGGTAGATTTAGGGTTAGGGTTAGGATTAGGGTTAGGGTTAGGGTTAGGGTTAGGGTTAGGGTTAGG
contig_60	reverse	GGGTTAGGGTTAGGGTTAGGGTTAGGGTTAGGGTTAGGGTAGGGTGCTCGGTTCCCGATTGCTTAGCAGTGCATATGTTTAACCTTAGCAATACGTAACT
contig_63	forward	CCCTAACCCTAACCCTAACCCTAACCCTAACCCTAACCCTAACCCTAACCCTAACCCTAAGATGGGCCAGTCCAGATCCAAACGGGCGGTTCGACTTGGT
contig_68	reverse	GTGCAAGGCGCAGGACCGCTCGACAGTCACTGGGCGCCAGCGCTTAGGGTTAGGGTTAGGGTTAGGGTTAGGGTTAGGGTTAGGTTAGGTTAGGGTTAGG
contig_7	forward	CCCTAACCCTAACCCTAACCCTAACCCTAACCCTAACCCTAACCCTAAACACTAACCCTAACCCGAAGCGGTGCGAGCTCCCGATGGAGTGAATCTGGCG
contig_7	reverse	CCTGAATCACCTGCGTGGCGAGGCGTCTTAGGGTTAGGGTTAGGGTTAGGGTTAGGGTTAGGGTTAGGGTTATGGTTAGGGTTAGGGTTAGGGTTAGGGT
contig_72	forward	TAACCCTAACCCTAACCCTAACCCTAACCCTAACCCTAACCTAACCCTAACCCTAAGGCGGACTCTCGCCCAGACGCAGACCAGCTGCATTGCAAAGGCT
contig_72	reverse	CATCAAGCCACCGACGTCGCTCGACCCCCACGGCGCGTCCCGAGCTCTTAGGGTTAGGGTTAGGGTTAGGGTTAGGGTTAGGGTTAGGGTTAGGGTTAGG
scaffold_47	forward	CCTAACCCTAACCCTAACCCTAACCCTAACCCTAACCCTGACCCTAACCCTAACCTTAACCTTAACCCTAACCCTAATCCTGACCCTAACCCTAACCCTA
scaffold_47	reverse	CGACCGCACGGGAGAACCAGCTCCTCGTCGTCGTCCCCCTCCCAGCTCTTAGGGTTAGGGTTAGGGTTAGGGTTAGGGTTAGGGTTAGGGTTAGGGTTAG
scaffold_5	forward	CCTAACCCTAACCCTAACCCTAACCCTAACCCTAACCCTAACCCTAACGCAGAACGAGCCGGCTCGATCGCGCGAGCGCCAAAGAGCGACATTCGCGCGC
scaffold_56	forward	GTTTTTTTTTTTTTTTTTAACCCTAACCCTAACCCTAACCCTAACCCTAACCCTAACCCTGGGTCCCGTTCGCGCTCGTCAAGGAGTCGATCCGCGAGGT

Telomeres found: 22 (13 forward, 9 reverse)
