scaffold_1	reverse	GGTTAGGGTAAGGGTAAGGGTAAGGGTTAGGGTTAGGGTTAGGGTTAGGGTTAGGGTTAGGGTTAGGGTTAGGGTTAGGGTTAGGGTTAGGGTTAGGGTT
scaffold_2	forward	AACCCTAACCCTAACCCTAACCCTAACCCTAACCCTAACCCTAACCCTAATCCTGACCTTAACCCTAACCCTAACCCTAATCCTAACCCTAACCCTGACC
scaffold_2	reverse	GGGCCAGAGTCAAGGGTTAGGGTTAGGGTTAGGGTTAGGGTTAGGGTTAGGGTTAGGGTTAGGGTTAGGGTTAGGGTTAGGGTTAGGGTTAGGGTTAGGG
scaffold_3	reverse	AGGTTAGGGGTAGGGTTAAGGGCTTAGGGTTAGGGTTAGGGTTAGGGTTAGGGTTAGGGTTAGGGTTAGGTTAGGGTTAGGGTTAGGGTTAGGGTTAGGG
scaffold_4	forward	TAACCCTAACCCTAACCCTAACCCTAACCCTAACCCTAACCCTAACCCTAACCCTAACCCTAACCCTAACCCTAACCCTAACCCTAACCCTAACCCTAAC
scaffold_4	reverse	GTTAAGGTTAGGGTTAGGGTTAAGGTTAGGGTTAGGGTTAGGGCTAGGGTTAGGGTTAGGGTTAGGGTTAGGGTTAGGGTTAGGGTTAGGGTTAGGGTTA
scaffold_5	forward	AACCCTAACCCTAACCCTAACCCTAACCCTAATCCTAACCCTAACCCTAACCCTAACCCTGACTCTAACCCTAACCCTAACCCTAACCTTAACCTTCACC
scaffold_7	reverse	TAGGGTTAGAGTTAGGGTTAAGGTTAGGGTTAGGGTTAGGGTTAGGGTTAGGGTTAGGGTTAGGGTTAGGGTTAGGGTTAGGGTTAGGGTTAGGGTTAGG
scaffold_8	reverse	GGTTAGGGTTAGGGTTAGGGTTAGGGTTAGGGTTAGGGTTAGGGTTAAGGTTAGGGTTAGGGTTAGGGTTAGGGTTAGGGTTAGGGTTAGGGTTAGGGTT
scaffold_9	forward	CCCTAACCCTAACCCTAACCCTAACCCTAACCCTAACCCTAACCCTAACCCTAACCCTAATCCTAACCTTAACCCTAACCCTAACCCTAACCCTAACCCT
scaffold_9	reverse	TAGGGTTAGGGTTAGGGTTAGGGTTAGGGTTAGGGTTAGGGTTAGGGTTAAGGTTAGGGTTAGGGTTAGGGTTAGGGTTAGGGTTGGGGTTAGGGTTAGG
scaffold_10	forward	ACCTAACCCTAACCCTAACCCTAACCCTAACCCTAACTCTAACCCTAACCCTAACCCTAACCCTAACCCTAAGTCAGCAAAGAGACTTGGGAGGAAGAGC
scaffold_10	reverse	AGGGTTAGGGTTAAGGTTAGGGTCAGGGTTAGGGTTAGGATTAAGGTTAGGGTTAGGGTTAGGGTTAGGGTTAGGGTTAGGGTTAGGGTTAGGGTTAGGG
scaffold_11	reverse	TTAGGGTTAGGGTTAGGGTTAGGGTTAGGGTTAGGGTTAAGGTTAAGGTTAGGGTTAGGGTTAGGGTTAGGGTTAGGGTTAGGGTTAGGGTTAGGGTTAG
scaffold_14	forward	AACCCTAACCCTAACCCTAACCCTAACCCTACCCTAACCCTAACCCTAACCCTAACCCTAACCCTAACCCTAACCCTAACCCTGACCCTAACCCTAACCC
scaffold_15	forward	CCCTAACCCTAACCCTAACCCTAACCCTAACCCTAACCCTAACCCTAACCCTAACCCTGACCCTAACCCTAACCCTGACCCTGACCCTAACCCTAACCCT
scaffold_16	forward	CCTAACCCTAACCCTAACCCTAACCCTAACCCTAACCCTAACCCTAACCCTAACCCTAACCCTAACTCTAACCCTAACCCTAACCCTAACCCTAACCTAA
scaffold_16	reverse	GTCAGGGTCAAGGTCAAGGGTTAGGGTTAGGGTTAGGGTTAGGGTTAGGGTTAGGGTTAGGGTTAGGGTTAGGGTTAGGGTTAGGGTTAGGGTTAGGGTT
scaffold_17	forward	CCCTAACCCTAACCCTAACCCTAACCCTAACCCTAACCCTAACCCTAACCCTAACCCTAACCCTAACCCTAACCCTAACCCTAACCCTAACCCTAACCCT
scaffold_18	forward	CCTAACCCTAACCCTAACCCTAACCCTAACCCTAACCCTAACCCTGACCCTAACCCTAACCCTAACCCTGACCCTAACCCTAACCCTAACCCTGCAAGGC
scaffold_21	reverse	TTAAGGTTAGGGTTAGGGTTAGGGTTAGAGTTAAGGTTAGGGTTAGGGTTAGGGTTAGGGTTAGGGTTAGGGTTAGGGTTAGGGTTAGGGTTAGGGTTAG
scaffold_22	forward	AACCCTAACCCTAACCCTAACCCTAACCCTAACCCTAACCCTAACCCTAACCCTAACCCTAACCCTAACCCTAACCTTAACCCTAACCTTAACCCTAACC
scaffold_24	reverse	GGTTAGGGTTAGGGTTAGGGTTAGGGTTAAGGTTAGAGTTAGGGTTAGGGTTAGGGTTAGAGTTAGGGTTAGGGTTAGGGTTAGGGTTAGGGTTAGGGTT
scaffold_26	forward	AACCCTAACCCTAACCCTAACCCTAACCCTAACCCTAACCCTAACCCTAACCCTAACCCTAACCCTAACCCTAACCCTAACCCTAATCCTAACCCTAATC
scaffold_27	forward	TAACCCTAACCCTAACCCTAACCCTAACCCTAACCCTAACCCTAACCCTAACCCTAACCCTAACCCTAACCCTAACCCTAACCCTAACCCTAACCCTAAC
scaffold_31	forward	CCTAACCCTAACCCTAACCCTAACCCTAACCCTAACCCTAACCCTAACCCTAACCCTAACCCTAACCCTAACCCTAGCCCTAACCCTAACCCTAACCCTA
scaffold_34	forward	CCCTAACCCTAACCCTAACCCTAACCCTAACCCTAACCCTAACCCTAACCCTAACCCTAACCCTAACCCTAACCCTAACCCTAACCCTAACCCTAACCCT
scaffold_35	forward	CCTAACCCTAACCCTAACCCTAACCCTAACCCTAACCCTAACCCTAGCCCTAACCCTAACCCTGACCCTAACCCTGACCCTAACCCTAACCCTAACCCTA
scaffold_37	reverse	GCGGATGTAATCTTAGGGTTAGGGTTAGGGTTTGCGGTTAGGGTTAGAGTTAGGGTTAGGGTTAGGGTTAGGGTTAGGGTTAGGGTTAGGGTTAGGGTTA
scaffold_38	reverse	AGGGTCAGGGTTAGAGTTAAGGTTAAGGTTAGGGTTAGGGTTAGGGTTAGGGTTAGGGTTAGGGTTAGGGTTAGGGTTAGGGTTAGGGTTAGGGTTAGGG
scaffold_39	forward	AACCCTAACCCTAACCCTAACCCTAACCCTAACCCTAACCCTAACCCTAACCCTAACCTTAACCCTGACCCTAACTCTAACTTTGACCCTAACCCTAACC
scaffold_40	reverse	AGGGTTAGGGCTAGGGTTAGGGTTAGGGTTAGGGCTAGGGTTAGGGTTAGGGTTAGGGTTAGGGTTAGGGTTAGGGTTAGGGTTAGGGTTAGGGTTAGGG
scaffold_42	reverse	AGGGTTAGGGTTAGGGTTAAGGTTAGGGTTAGGGTTAGGGTTAGGGTTAGGGTTAGGGTTAGGGTTAGGGTTAGGGTTAGGGTTAGGGTTAGGGTTAGGG
scaffold_45	reverse	GGTTAGGGTCAGGGTTAGGGTTAGGGTTAGGGTTAGGGTTAGGGTTAGGGTTAGGGTTAGGGTTAGGGTTAGGGTTAGGGTTAGGGTTAGGGTTAGGGTT

Telomeres found: 34 (17 forward, 17 reverse)
