contig_1	forward	CCCTAACCCTAACCCTAACCCTAACCCTAACCCTAACCCTAACCCTAACCCTAACCCTAACCCTAACCTAACCTAACCCTAACCCTAACCTTCGAATGGT
contig_10	forward	AACCCTAACCCTAACCCTAACCTAACCCTAACCCTAACCCTAACCCTAACCCTAACCTAACCCATAACCCTAACCCTAACCCTAACCCTAACCCTACTCC
contig_12	reverse	GGGTTAGGGTTAGGGTTAGGGTTAGGGTTAGGGTTAGGGTTAAGGTTAGGGTTAGGGTTAGGGTTAGGGTTAGGGTTAGGGTTAGGGTTAGGGTTAGGGT
contig_13	forward	CCTAACCCTAACCCTAACCCTAACCCTAACCCTAACCCTAACCCTAACCCTAGCCCTAACCCTAACTCTAACCCTAACCCTAACCTGTGCGAAAAGTTCC
contig_13	reverse	TTAGGATTAGGGTTATGGTTAGGGTTAAGGTTAGGGTTAGGGTTAGGGTTAGGGTTAGGGTTAGGGTTAGGGTTAGGGTTAGGGTTAGGGTTAGGGTTAG
contig_14	reverse	TAGGGTTAGGGTTAAGGCGAGGGTTAGGGTTAGGGCTAGGGTTAGGGTTAGGGTTAGGGTTAGGGTTAGGGTTAGGGTTAGGGTTAGGGTTAGGGTTAGG
contig_2	reverse	TAGGTTAGGGTTAGGATCAAGGTCAGGGTTAGGGTTAGGGTTAAGGTTAGGGTTAGGGTTAGGGTTAGGGTTAGGGTTAGGGTTAGGGTTAGGGTTAGGG
contig_20	reverse	GGGGTAGGGTTAGGGTTAGGGTTAGGGTTAAGGATAAGGTTAGAGTTAGGGTTAGGGTTAGGGTTAGGGTTAGGGTTAGGGTTAGGGTTAGGGTTAGGGT
contig_21	forward	ACCCTAACCCTAACCCTAACCCTAACCCTAATCCTAACCCTAACCTTAACTCTAACCCTAACCCTAACCCTAACCTAACCCTAACCCTAGGTCATTTTTC
contig_22	reverse	CCCCTTCAGTTGTGCTCAGTTAAGGTTAGGTTAGGTTAGGTTAGGGTTAGGGTTAGGGTTAGGGTTAGGGTTAGGGTTAGGGTTAGGGTTAGGGTTAGGG
contig_28	forward	ACCCTAACCCTAACCCTAACCCTAACCCTAACCCTAACCCTAACCCTAACCCTAACCCTAACCCTAACCCTAATCCTAACCCTAATCCTAACCTACTCTA
contig_30	forward	CCCTAACCCTAACCCTAACCCTAACCCTAACTCTAACCCTAACCCTAACCCTAACCCTTAACCCTAACCCTAACCTAACCCTAACCCTAACCGGACTGGG
contig_30	reverse	GGTTAGGGTCAGGGTCAGGGGTAGGGTTAGGGTTAGGGTTAGGGCTAGGGTTAGGGCTAGGGTTAGGGTTAGGGTTAGGGTTAGGGTTAGGGTTAGGGTT
contig_4	forward	CCTAACCCTAACCCTAACCCTAACCCTAACCCTAACCCTAACCCTAACCTAACCCTAACCCTAACCCTAACCCTAACTTTAACCCTAACCCTAACTTTAA
contig_4	reverse	GGGTTAAGGGTTAAGGTTAGGATTAGAGTTAGGGTTAGGGTTAGAGTTAGGGTTAGGGTTAGGGTTAGGGTTAGGGTTAGGGTTAGGGTTAGGGTTAGGG
contig_6	reverse	ATCGCCTTAGGGTTAGGGTTAGGGTTAGGGTTAGGGTTAGGGTTAGGGTTAGGGTTAGGGTTAGGGTTAGGGTTAGGGTTAGGGTTAGGGTTAGGGTTAG
contig_7	reverse	AGGTTAGGGTTAGGGTAAGGATTAGGGTTAGGGTTAGGGTTAGGGTTAGGGTTAGGGTTAGGGTTAGGGTTAGGGTTAGGGTTAGGGTTAGGGTTAGGGT
contig_8	forward	CTAACCCTAACCCTAACCCTAACCCTAACCCTAACCCTAACCCTAACCCTAACCCTAACCCTAACCCTAACCCTAACCCTAACCCTAACCCTAACCCTGA
contig_9	reverse	GAGAATACTGACTTTGGGGGCCTTCTCCCAGTAGCAGAAGAGAACTGAAAATACGTCGTTCCTTAGGGTTAGGGTTAGGGTTAGGGTTAGGATTAGAGTT

Telomeres found: 19 (8 forward, 11 reverse)
