KQ954471.1 Rhodotorula sp. JG-1b unplaced genomic scaffold RHOSPscaffold_8, whole genome shotgun sequence	reverse	GCCTcagggttagggttagggttagggttagggttagggttagggttagggttagggttagggttagggttagggttagggttagggttagggttagggt
KQ954473.1 Rhodotorula sp. JG-1b unplaced genomic scaffold RHOSPscaffold_10, whole genome shotgun sequence	reverse	TGATCTTaggttagggttagggttagggttagggttagggttagggttagggttagggttagggttagggttagggttagggttagggttagggttaggg
KQ954479.1 Rhodotorula sp. JG-1b unplaced genomic scaffold RHOSPscaffold_16, whole genome shotgun sequence	forward	ctaaccctaaccctaaccctaaccctaaccctaaccctaaccctaaccctaaccctaaccctaaccctaaccctaaccctaaccctaacctaacctcgtc
KQ954480.1 Rhodotorula sp. JG-1b unplaced genomic scaffold RHOSPscaffold_17, whole genome shotgun sequence	reverse	gttaggttagggttagggttaggttaggttagggttagggctagggttagggttagggttagggttagggttagggttagggttagggttagggttaggg
KQ954484.1 Rhodotorula sp. JG-1b unplaced genomic scaffold RHOSPscaffold_21, whole genome shotgun sequence	forward	accctaaccctaaccctaaccctaaccctaaccctaaccctaaccctaaccctaaccctaaccctaaccctaaccctaacctAACCCTAACCTAAAACtc
KQ954487.1 Rhodotorula sp. JG-1b unplaced genomic scaffold RHOSPscaffold_24, whole genome shotgun sequence	reverse	CTTGagttagggttagggttagggttagggttagggttagggttagggttagggttagggttagggttagggttagggttagggttagggttagggttag
KQ954492.1 Rhodotorula sp. JG-1b unplaced genomic scaffold RHOSPscaffold_29, whole genome shotgun sequence	forward	ctaaccctaaccctaaccctaaccctaaccctaacaTTAACCCTAGCCCTAACCTAACCCTAACCGCCTCCTTGCCCCCTCCGTACTCCGCTGAAATGAT
KQ954493.1 Rhodotorula sp. JG-1b unplaced genomic scaffold RHOSPscaffold_30, whole genome shotgun sequence	forward	accctaaccctaaccctaaccctaaccctaaccctaaccctaaccctaaccctaaccctaaccctaaccctaaccctaaccctaaccctaaccctgaccc
KQ954497.1 Rhodotorula sp. JG-1b unplaced genomic scaffold RHOSPscaffold_34, whole genome shotgun sequence	forward	cctaaccctaaccctaaccctaaccctaaccctaaccctaaccctaaccctaaccctaaccttaaccctaaccctaaccctacccctaaccctaacccta
KQ954498.1 Rhodotorula sp. JG-1b unplaced genomic scaffold RHOSPscaffold_35, whole genome shotgun sequence	reverse	gttagggttagggttacGGTTAGGGTTACGGCTAGAGTCAGAGGTAAGGTTAGGTTAGGGTTAaggttagggttagggttagggttagggttagggttag
KQ954500.1 Rhodotorula sp. JG-1b unplaced genomic scaffold RHOSPscaffold_37, whole genome shotgun sequence	reverse	AGGGgtagggttagggttagggttagggttagggttagggttagggttagggttagggttagggttagggttagggttagggttagggttagggttaggg
KQ954502.1 Rhodotorula sp. JG-1b unplaced genomic scaffold RHOSPscaffold_39, whole genome shotgun sequence	reverse	TGGGtgttagggttagggttagggttagggttagggttagggttagggttagggttagggttagggttagggttagggttagggttagggttagggttag
KQ954503.1 Rhodotorula sp. JG-1b unplaced genomic scaffold RHOSPscaffold_40, whole genome shotgun sequence	forward	cctaaccctaaccctaaccctaaccctaaccctaaccctaaccctaaccctaaccctaaccctaaccctaaccctaaccctaaccctaaccctaatccta
KQ954504.1 Rhodotorula sp. JG-1b unplaced genomic scaffold RHOSPscaffold_41, whole genome shotgun sequence	forward	aaccctaaccctaaccctaaccctaaccctaaccctaaccctaaccctaaccctaaccctaaccctaaccctaaccctaaccctaaccctaaccctaacc
KQ954506.1 Rhodotorula sp. JG-1b unplaced genomic scaffold RHOSPscaffold_43, whole genome shotgun sequence	reverse	Aaggttagggttaggggtagggttagggttagggttagggttagggttagggttagggttagggttagggttagggttagggttagggttagggttaggg
KQ954517.1 Rhodotorula sp. JG-1b unplaced genomic scaffold RHOSPscaffold_54, whole genome shotgun sequence	forward	taaccctaaccctaaccctaaccctaaccctaaccctaaccctaaccctaaccctaaccctaaccctaaccctaaccctaaccctaaccctaaccttaac
KQ954522.1 Rhodotorula sp. JG-1b unplaced genomic scaffold RHOSPscaffold_59, whole genome shotgun sequence	reverse	AGGGggggttagggttagggttagggttagggttagggttagggttagggttagggttagggttagggttagggttagggttagggttagggttagggtt
KQ954525.1 Rhodotorula sp. JG-1b unplaced genomic scaffold RHOSPscaffold_62, whole genome shotgun sequence	forward	taaccctaaccctaaccctaaccctaaccctaaccctaaccctaaccctaaccctaaccctaaccctaaccctaaccctaaccctaaccctaacctTAAC
KQ954526.1 Rhodotorula sp. JG-1b unplaced genomic scaffold RHOSPscaffold_63, whole genome shotgun sequence	reverse	GCCGGAGGTCGAAGTTGGAGTCGGAACCGAAGGTGAAAGGCTAACACGCGCcttagggttagggttagggttagggttagggttagggttagggttaggg
KQ954528.1 Rhodotorula sp. JG-1b unplaced genomic scaffold RHOSPscaffold_65, whole genome shotgun sequence	forward	taaccctaaccctaaccctaaccctaaccctaaccctaaccctaaccctaaccctaaccctaaccctacCCCTAgccctaaccctaaccctaaccctaac
KQ954530.1 Rhodotorula sp. JG-1b unplaced genomic scaffold RHOSPscaffold_67, whole genome shotgun sequence	forward	taaccctaaccctaaccctaaccctaaccctaaccctaaccctaaccctaaccctaaccctaaccctaaccctaaccctaaccctaaccctaaccgAAAG
KQ954531.1 Rhodotorula sp. JG-1b unplaced genomic scaffold RHOSPscaffold_68, whole genome shotgun sequence	reverse	GTTAAagttagggttagggttagggttagggttagggttagggttagggttagggttagggttagggttagggttagggttagggttagggttagggtta
KQ954535.1 Rhodotorula sp. JG-1b unplaced genomic scaffold RHOSPscaffold_72, whole genome shotgun sequence	forward	accctaaccctaaccctaaccctaaccctaaccctaaccctaaccctaaccctaaccctaaccctaaccctaaccctaaccctaaccctaaccctcACCC
KQ954540.1 Rhodotorula sp. JG-1b unplaced genomic scaffold RHOSPscaffold_77, whole genome shotgun sequence	reverse	TAGGGTTAGGTTAGGGTTaggttagggttagggttagggttagggttagggttagggttagggttagggttagggttagggttagggttagggttagggt
KQ954545.1 Rhodotorula sp. JG-1b unplaced genomic scaffold RHOSPscaffold_82, whole genome shotgun sequence	forward	accctaaccctaaccctaaccctaaccctaaccctaaccctaaccctaaccctaaccctaaccctaaccctaacctAACCCTAACCTAACCCTAACTGCG
KQ954555.1 Rhodotorula sp. JG-1b unplaced genomic scaffold RHOSPscaffold_92, whole genome shotgun sequence	forward	ctaaccctaaccctaaccctaaccctaaccctaaccctaaccctaaccctaaccctaaccctaaccctaaccctaaccctaaccctaaccctaactCTAG
KQ954556.1 Rhodotorula sp. JG-1b unplaced genomic scaffold RHOSPscaffold_93, whole genome shotgun sequence	reverse	TGGCaggttagggttagggttagggttagggttagggttagggttagggttagggttagggttagggttagggttagggttagggttagggttagggtta
KQ954560.1 Rhodotorula sp. JG-1b unplaced genomic scaffold RHOSPscaffold_97, whole genome shotgun sequence	reverse	GGAGctagggttagggttagggttagggttagggttagggttagggttagggttagggttagggttagggttagggttagggttagggttagggttaggg
KQ954565.1 Rhodotorula sp. JG-1b unplaced genomic scaffold RHOSPscaffold_102, whole genome shotgun sequence	forward	ccctaaccctaaccctaaccctaaccctaaccctaaccctaaccctaaccctaaccctaaccctaaccctaacctaaccctaacctaaccctaaccctaa
KQ954568.1 Rhodotorula sp. JG-1b unplaced genomic scaffold RHOSPscaffold_105, whole genome shotgun sequence	forward	accctaaccctaaccctaaccctaaccctaaccctaaccctaaccctaaccctaaccctaaccctaaccctaaccctaaccctaaccctaaccctgGTCC

Telomeres found: 30 (16 forward, 14 reverse)
